150.0 0.0 0.0 
85 85 85 86 86 86 86 86 86 86 87 87 87 87 87 87 88 87 88 88 89 89 90 90 113 112 112 112 91 113 113 113 113 114 114 114 115 116 116 117 255 167 255 255 255 255 255 255 255 255 255 255 255 255 255 255 255 255 255 255 255 255 255 72 71 70 70 69 69 70 69 70 69 69 69 69 69 70 69 69 53 53 52 52 52 52 51 51 51 51 50 
310.0 0.0 0.0 
199 200 200 200 200 200 199 201 201 201 203 201 202 202 255 255 255 255 255 255 255 255 255 255 255 255 255 255 255 255 255 255 255 255 255 255 255 255 255 255 16 255 255 149 255 255 255 255 255 255 255 255 255 255 255 255 255 255 255 255 255 255 255 255 255 255 255 255 255 255 255 255 255 255 61 255 58 57 56 55 55 54 54 54 53 53 53 52 53 53 53 
390.0 0.0 0.0 
29 29 28 28 28 28 29 28 28 87 31 34 67 66 65 45 61 46 103 102 72 71 242 255 255 255 255 70 255 28 255 255 71 70 69 69 69 68 68 68 68 68 68 68 68 68 68 43 68 68 68 68 68 68 68 68 68 68 68 27 69 69 71 70 73 70 40 32 77 40 80 80 71 74 58 58 56 57 56 56 56 28 55 55 55 55 54 55 29 54 54 
390.0 -60.0 -90.0 
13 13 13 13 13 13 14 14 15 15 15 15 15 15 15 24 24 24 24 255 29 255 255 255 255 255 224 255 255 255 255 255 255 137 137 136 136 135 135 135 135 110 134 134 135 134 134 134 135 134 134 135 135 135 107 135 115 27 136 26 27 155 155 155 155 155 156 255 157 255 255 255 156 255 100 79 75 75 75 74 74 73 73 73 73 73 72 72 73 72 72 
390.0 -110.0 -90.0 
255 255 111 109 109 109 108 109 109 108 110 110 255 68 112 255 205 255 255 255 255 255 255 255 255 255 255 255 255 255 255 99 255 88 255 87 86 86 85 85 85 85 85 85 85 85 85 85 85 85 85 85 85 85 85 85 86 86 86 87 87 88 113 112 113 113 113 113 113 113 113 40 113 113 114 114 112 96 74 73 73 72 72 72 72 71 71 71 71 71 71 
310.0 -110.0 180.0 
156 255 255 255 255 255 255 255 255 255 255 255 255 255 255 90 255 59 255 255 242 93 29 28 29 30 69 105 155 141 30 255 30 34 201 33 172 210 160 101 92 124 220 255 255 255 61 185 255 255 255 255 92 255 255 255 255 255 93 255 255 255 255 255 255 255 255 255 255 255 255 255 255 255 255 152 255 29 30 91 90 79 89 89 89 88 88 88 88 88 87 
250.0 -110.0 -135.0 
29 86 69 86 112 70 70 86 69 70 69 31 48 145 62 30 31 33 32 45 44 43 43 42 149 138 255 255 255 109 255 69 42 42 255 255 52 36 255 255 255 104 95 78 112 110 255 255 98 255 94 125 38 84 84 56 66 83 83 82 82 82 82 81 81 81 81 81 81 81 81 81 81 81 81 81 81 81 81 82 82 82 82 83 83 83 84 83 85 86 87 
190.0 -110.0 180.0 
23 23 24 23 23 23 23 23 24 24 24 24 24 24 24 24 25 25 24 24 25 25 26 26 27 26 28 28 255 28 255 255 255 255 255 255 255 255 255 255 255 255 255 255 255 255 255 255 255 255 255 255 255 255 255 255 255 255 255 255 255 255 255 255 255 255 255 255 255 255 255 255 147 34 25 24 24 24 24 24 24 24 23 23 23 23 22 18 17 17 17 
110.0 -110.0 -30.0 
49 84 84 84 83 83 81 82 82 82 82 82 82 82 82 81 81 81 82 50 49 48 48 48 49 48 55 49 66 83 83 83 84 84 87 88 255 255 255 255 255 255 255 255 255 255 255 255 255 255 255 255 255 255 255 255 255 255 255 255 255 255 255 255 255 255 255 255 255 255 255 255 255 38 39 175 41 42 170 47 255 255 255 255 255 255 255 255 255 110 95 
